##############################################       
#     #     #     #        #        #        o
#######  #  #  #  ####  #  #  #  #  #######  #
#        #  #           #     #  #  #     #  #
#  #######  ####  #############  #  #  #  #  #
#  #     #     #  #  #        #  #     #     #
#  ####  #######  #  #  ####  ##########  ####
#     #           #  #     #           #     #
####  #############  ####  #  #######  ####  #
#     #           #     #  #     #     #  #  #
#  ####  #######  #  #  #  #######  ####  #  #
#  #     #        #  #     #  #     #     #  #
#  ##########  ####  #######  #  ####  ####  #
#           #     #  #        #  #     #  #  #
##########  #  #  #  #  #######  #  ####  #  #
#           #  #     #     #     #     #     #
#  ######################  #  #######  #  ####
#     #                 #  #           #     #
####  #  #############  #  ##########  ####  #
#     #  #              #           #        #
#  ####  #  #  ##########  #######  ####  #  #
#  #  #  #  #        #        #  #     #  #  #
#  #  #  ##########  #  ####  #  ####  #  ####
#     #           #  #     #  #  #     #     #
#  #############  #  #  #  #  #  #  #######  #
#  #     #     #  #     #  #  #  #        #  #
#  #  ####  ####  #######  #  #  #######  #  #
#  #              #        #  #        #     #
#  #  ####  ##########  ####  ####  #  ####  #
#     #     #           #     #     #        x
##############################################